.. . . . . . . . . . . . . . . . . . . . . . . . . . . . .      
.. . . . . . . .#######. . . . . . . . . . . . . . . . . .      
.. . . . . . .#. .#### . . . ####. . .###############. . .      
.. . ########. ##. ##. . . ######################### . . .      
.. . . ##########. . . . ######################. . . . . .      
.. . . .######## . . . .   ################### . . . . . .      
.. . . . ### .   . . . .#####. ##############. # . . . . .      
.. . . . . ##### . . . .#######. ##########. . . . . . . .      
.. . . . . .###### . . . .#### . . . . .## . . . . . . . .      
.. . . . . . ##### . . . .#### # . . . . . ##### . . . . .      
.. . . . . . ### . . . . . ##. . . . . . . . ### .#. . . .      
.. . . . . . ##. . . . . . . . . . . . . . . . . . . . . . 
.. . . . . . . . . . . . . . . . . . . . . . . . . . . . .     
